  |HW|  |  |  |HW|  |  |  |  |HW|  
  |  |  |  |  |  |  |  |  |  |  |  
  |  |DM|  |  |IM|  |  |DM|  |  |  
  |  |  |DM|  |  |  |DM|  |  |  |  
  |  |  |  |DM|  |DM|  |  |  |  |  
  |HW|  |  |  |HW|  |  |  |  |HW|  
  |HW|  |  |  |HW|  |  |  |  |HW|  
  |  |  |  |DM|  |DM|  |  |  |  |  
  |  |  |DM|  |  |  |DM|  |  |  |  
  |  |DM|  |  |IM|  |  |DM|  |  |  
  |  |  |  |  |  |  |  |  |  |  |  
  |HW|  |  |  |HW|  |  |  |  |HW|  