  |  |  |  |  |DM|  |  |  |  |  |  
  |  |  |  |  |DM|  |  |  |  |  |  
  |  |  |  |  |DM|  |  |  |  |  |  
  |  |IM|  |  |DM|  |  |  |IM|  |  
  |  |IM|  |  |DM|  |  |  |IM|  |  
  |HW|IM|  |  |DM|  |  |  |IM|HW|  
  |HW|IM|  |  |DM|  |  |  |IM|HW|  
  |  |IM|  |  |DM|  |  |  |IM|  |  
  |  |IM|  |  |DM|  |  |  |IM|  |  
  |  |  |  |  |DM|  |  |  |  |  |  
  |  |  |  |  |DM|  |  |  |  |  |  
  |  |  |  |  |DM|  |  |  |  |  | 